####################################
#   #         #          #         #
### ### ####### # #### ###### ######
#       #       #    #      #      #
# ####### ########## ######## #### #
#   #              #    #        # #
### ########## ######## #### #######
#          #        #        #     #
######### ##### ####### ###### #####
#           #       #          #   #
#### ###### ####### # ######## #####
#       #   #       #        #     #
### ####### # ####### ##### ###### #
#         #        #    #     #E   #
####################################
