####################################
#   #          #         #         #
# # ### ##### ##### #### ## ######## 
# #         #       #              #
# ####### ### ########## ####### ###
# #       #       #    #      #    #
### ####### ######## #### ######## #
#        #       #        #        #
# ###### ########## #### ######### #
#  #   #       #      E#           #
# ## ####### ####### ########## ## #
#          #     #         #     # #
# ####### ### # ###### ##### ##### #
# #     #     #      #        #    #
####################################
