####################################
#       #    #        #            #
# ### #### ### ###### ###### #### ##
# #   #        #    #        # #   #
# ### ## ####### ## ####### ## # ###
#             #          #     #   #
###### ###### ### ##### ##### ### ##
#   #  #       #  #     #       #  #
### ## ### ###### #### ####### #####
#   #    #  #       #          #   #
# ###### #### ##### ########## ### #
# #       #   #     #  #       # # #
# # ######### ###E#### # #### ### ##
# #           #  #     # #         #
### ######### ## ####### # #### ## #
#   #      #     #    #     #    # #
# ###### ###### # ###### ##### #####
#        #      #    #         #   #
####################################
